1010101010
1010101010
1010100000
1000000000
0010001010
0010000000
0000000000
0010100000
0000000000
0000000000